330102322
132344443
110234410
333431400
044420343
113000404
421103143
021242240
230124121
