00142230322103403323333232400003440340220420232204204222224333223
40100000402010400040201010201020304000402010402040002000104000400
40010002010111000002440002020102320343042202240200034400010040013
30204040202000401040400040404030301020400020000000403010002020203
24010401244300143104004011110043301202012422000402140414201100204
40102020303040203020304040201020400000103000404040403020200030200
20003104220031042200440224012402100200044202110111034304040344042
00002020401030401020201040104000404040402010103010402040400040404
22034042010240301410101201024320010401110210204202040021010404242
20400020101040004020002010100020001020204040304040103000004040101
30034004220031010402240120002402400242012202200014024304040440040
40102020202000303030104010001020001020004020104000403010104040200
14120111234300404342041202200242110204044022034404140414324300443
40004040404040202030202000401040304000000020003010004020202010000
44023202210112043000220012011404420422020201110204010204430011043
20204030104040102020002000404010003020202000302000002020002020200
04024042012402120042120410241102034402004324342402220132434033424
40000040402000201000001000102010204010203040302010400010403020402
22004403420442041004020101021200020010003102100400040400220100022
30402010002020402040401040002040201040203030101000100020004020201
33220211234302421043000011210101010100443442042043300342204403400
00000010003020002020202000100020300020003040104000200000204020001
24011004000124041004120210011103430043024301000424001103400011042
20402020402040201000001000204040304000303030401020000020300040103
40430121022014210024232402440120002412420044222000400400022012243
30402010401040101010201020401000000000302000201000202000402020204
34010000240401011004110240022403430404034002240002024203400411010
20204010304040401000204020102040200020000030402010403040202000404
24400124420002222110024322100201021000432442022334140412144400224
00304010002040402040003030203000201000204030102040400020304010003
02002101040412012100210134034002210132020100200124004400430120012
10101000200040400000400040202030404030300020000040103000200020004
04111440204404001342003340000443202340440042332044344244004214202
20100030003040200040300020202040000020002020000000002040404010400
04001204020220004304440420001404400432002102010000044404000022034
00104000102010204000402030202000204000400010000030404010000040003
20040404011100443411044334420004423204102222003043300101202202000
20204010401020304040102010300000304020402040300040204010004010004
22010104440201003104300104040404020414024303440401044300110210020
40004040400010300020000020001000400020404020201010403010200040404
00140124021120404420400404042033233322240403400421034420002213442
40400020300040302010000040203040000000401040200040103010402020204
14041003440210020400210043002400000340040100340342010002020412040
10100020002010404010001000204040202030002010004030200040000020300
04120442404300420120020212440020202104221410042210210100144304424
20404020002040400010404000200000401000402020400030402040402000004
20004204320420044002010220042001210100021201110440022403440042000
00004040000040200030402010103010301020400040400000400020401040202
40220242344324120043110112023100310224421244034300002240243224243
40102000204020400040302010200020000000202000403020202030300040400
02042000010410003404440020042104340224022104040101041201320444023
00400030404010400010204040200000401000200010002020101030000020202
31010343100100324401024201040000420004044020042433120444222204420
40404040104000203000404040102000004020400020201040202020404040201
01042102100421023201010040004204240424004002010043002204110442020
00400040401040002020100020402000302030300010004030003020000020101
34042100022211201420204401242323442233420222440444332012022010200
00402010001040004010400020100040404040402040204040002000400020202
34022204100122012004140404012201040021034301300200041203430224001
30101020400040402040101010102000103040403000202010102000300040201
22210444202000100400042012200210334202201224034024120443221104100
20100020200030001040304040102010400020004010000020101000204040402
42012204010240022403430032001002310400020201220422043402310214003
20402000204030102020001040200020402040400040003000400010400020400
00204240101200040124220433040120404402102430204004304404204004404
