30004401044201203020440420012433204003304400242402434204402200402
40002010004020102010204010102000002040202000200000204020001000304
04040102120420022104340404001404040024034201240042010100430022042
40401040403020001020004040401020400040203000100040001010304010104
30440212034404201114040101040424004402102222041112440414221001021
00304020200000400020401020002040404000100040002030401010204010404
40003000120224002200300110002002420211024402440043040200440202001
30202040004020402010000040403040000020404030304020400010401000304
04004332012014240433430204344404101220440440434322034231023442440
00003020302000002010002020104020401030001020300040100040002040404
44003000440122034202310124010204210024022104220340034001220130011
20300020302010204000400000202000200000104020004030403000200010403
00430442010204211211012202100044140002304202041404000124024204012
20000000402040100010201000000020002000202010101020201000003000403
22040400200422021201010112000001120214002400010111040400220200002
20404020200020404000004000204040004000404040204020004040001020403
23432404104312420001202104102342022224111242042400421024332344044
20300010003000204020201020001000401010001040304030200000404000202
11002400000211012401110221000104000404011000440040012204240031010
10202040401010204000104030404010200000401020004000202040404000204
02000042211400022222024042010220404204420443004311240424434300423
20202040004040000000404000400010304020402000202010204040404020400
00034400000210001402020022022401300112001102020401040004320231000
00002040001040000030004020102020404040402040102020401030200000002
00324034042412421340430002100422402333200442024312422240013343303
20403000204020304020000010402010002000000030200040400020004000402
24023103440100042203430422012201320224022102210000010002010424020
30200030204010400020202010000020002020004020000010202020200010002
43310443024004221244042003400213344000010211041110240042224404013
30104020000010100020400020204000200000002010204000200000202040402
00020401120021011403430420023200010202001001010014001401300343023
10200000200000004040200040402020002010402000402020202010301020203
04422420013243220340400343024042201211221424112104133320432034203
40304040201000402040000030000000001000000010200020202000200030004
00040401110022041201300202034302240120010001100001040402010111010
00001040201020404000202020203020400040400040000000200010404000000
40300010022200000004040342040240100004021424044402010123324402204
30201010101040401020404000100040100000003000000000402040402040204
20003002200114002102020004041100010411034400100044002401210012040
20200040404040204020302010104000000000404040104020200020400020404
30024402020112112323420401232340221201210412243224431014004414000
30404000004000204040301010400000200000102040100040302000200000102
22010000020242004404240214001001310012011200040444011202430002011
30002020202040303000200040304000001010404030402020400010302040400
34140343004204404043004302420201200400400240040024430102021204142
40000000202040404020404040202010002020300030000040300000002020002
00011403440414040400400432012202240001002104110404010200010020011
00200020302000404000403030000000400020200020401040404030102000001
42343040432104020400244044222242243443331343112102034344224242000
00003030400040200000304020201040101000004040100000103030102040004
02034301200443010002220240020400140122020100040022034300010432002
00402010204030202000000040001020000000001040204000104040002040204
43340102422100200044010120110440000401232024022444340211242200140
30202020302040204040401020102000102000202010300040204000000040102
20012200340404010001040214000100210202020203440122000204210032020
10204010401000002010401020003020402040402010401010401030001000404
04211402002114220012100202044431034420240020220413440344013042010
20202010101010004010100000003000300040402010004040404000001000103
12024402110400034401110343044304400111024300220421012001240342034
00003040101000404000204030304000301020100000201030404020004020403
00000442121402210011020043420000102102203444011120010114024403420
40401000400010100000402000202040401000003000201000102020303010000
20000402140011010104240231020203440414043102040121022200400420041
00401010000020200010000000404020404040204010001010004000302000400
20322010020100102410012423401401044301044203420010204004322224012
