213444210
441210040
034404222
130410034
044121422
034313324
144134020
022330312
011001403
